111111111111111111
100E00000000000C01
100000000000000011
100000C00000 00111
100C00000000001111
1000000P0000011111
111111111111111111
