11111111111111111
1C000000000011111
1111111E111100001
10000000001000C01
10000000001000001
10000100001000001
10000000000100001
10C00000000000001
10001110001100P01
11111111111111111
