111111111111111111
100E00000000000C01
10000000000000001
100000C000000001
100C00000000001
1000000P000001
1111111111111
