111111111111111111
100E00000000000C01
100000000000000001
100000C00000000001
100C00000000000001
1000000P0000000001
111111111111111111
