11111111111111
111E1111111111
11111111111111
11111111111C11
11111111111111
11111111111111
111P1111111111
11111111111111