11111111111111111
1E000000000000001
1011100C001100001
10000000001000C01
1000C000001000001
10000100001000001
10000000000100001
10C00000000000001
10001110001100P01
11111111111111111
