1111111111111
11111E11100S1
111SSCSS10101
11111S11101S1
111SSSSS101C1
1111101110111
111SCSSC10111
1111101110111
1C111S0000111
1S11111110111
1S1111111C111
1S00000000111
1111111110111
1SSS0P0000111
1111111111111