11111111111
1S000000001
1S111111101
10100000001
10101111101
1S101111101
10101111101
1S1C00010C1
10100100011
1S100000001
10010000001
1S100000101
10010000001
1S1000100C1
10100000111
10100000C01
1E1000001P1
11111111111