1111111111111
111111E111111
111111C111111
10S00S00S00S1
1011111111101
1S11111111101
100S00S00S001
111111C111111
1S0000S000CC1
11111111111C1
11S000S000S01
111C111111111
111S0000SC111
111111C111111
11110000S1111
111111S111111
111111P111111
1111111111111