11111
11E11
1SSS1
1SS01
1SSS1
1SS01
1SSS1
10SS1
1SSS1
10SS1
1SSS1
1S0S1
1SSS1
1SS01
1SSS1
1SSS1
10SS1
11C11
11P11
11111