111111111111111
1E111C11C1S0001
1000000S010CC01
11110111010CC01
11S0S0S100000S1
111101111011111
1C0000SC101P0C1
101010101011011
1CS0000C0000001
111111111111111