1111111
111E111
1110111
1S0S001
100C001
100S0S1
111S111
111P111
1111111