1111111111111
1C1SS1E1SS1S1
1S1SS101SS1C1
1C111101111S1
1S1SSSCSSS1S1
1S111101111S1
1S1SSSCSSS1S1
1011110111101
1CS0S0S0000P1
1111111111111