1111111
1P01001
11S1011
1SSSS01
111C111
1SSS001
111S111
1CSS0C1
1101011
1S010E1
1111111