111111111111111
11P111111111E11
110111111111011
110111111111C11
10SC1111111SSS1
110111111111011
110111111111011
110001111100011
111101111101111
111101111101111
1CSS00111CS00S1
11101111111S111
111011111110111
11001111111C011
110111111111011
110111111111011
1S00S11111S0001
11S111111111011
110111111111011
1100S00S0000011
111111111111111