111111111111111111
1CC000000000000C01
1C0011110011100001
1C0000C00000000001
1C00010011111111C1
1000P01000000000E1
111111111111111111
